apple=AAPL
microStrategy=MSTR
AMD=AMD
amazon=AMZN
Bae=BA.L
BerkshireHathaway=BRK-A
bitcoin=BTC-USD
Gold=GLD
google=GOOG
CrudeOil=HUC.TO
ftse100=ISF.L
JPMorgan=JPM
LockheadMartin=LMT
Meta=META
MicroSoft=MSFT
nasdaq100=QQQ
SP500=SPY
Telsa=TSLA
TenYearTreasury=TNX
Activision=ATVI
airbnb=ABNB
americanExpress=AXP
americanTower=AMT
bankOfAmerica=BAC
Blackstone=BX
Boeing=BA
BroadCom=AVGO
CitiGroup=C
CME=CME
Ford=F
GeneralMotors=GM
HP=HPQ
IBM=IBM
intel=INTC
J&J=JNJ
matercard=MA
mcdonalds=MCD
monster=MNST
morganStanley=MS
nasdaq=NDAQ
nike=NKE
paypal=PYPL
pepsiCo=PEP
Pfizer=PFE
RealtyIncome=O
SalesForce=CRM
starBucks=SBUX
Visa=V
walmart=WMT
wellfargo=WFC
willisTowersWatson=WTW
bitcoin_metrics=bitcoin_metrics